WE textures/spaceship/wall_1.xpm
EA textures/spaceship/wall_2.xpm
NO textures/spaceship/wall_3.xpm
WE textures/spaceship/wall_4.xpm

F 100,200,122
C 122,122,122





111111111111
10010000000011111111111111111111111111111                                                   1111111111111111111111111
100100000000111111111111111111111111111                                                          11111111111111111111
10010011111111111111111111111111111111111
100E0000000001
10111000000001000000000000000000000000000000000000000000000000000000000000000000000000000000000000000000000000000000
1111111111111
100000111111111111111111111111111111111111111
1111010000001000000000000000000000000000011100000000000000000000000000000000000000000000000000000000000000000000000
1111111111111000000000000000000000000000001111
00000000000000000000000000000000000000000000000000
